name:                regexdispatcher
version:             0.1.0.0
synopsis:            Generates regex-representations of specification keywords
description:         Generates regex-representations of specification keywords
homepage:            https://www.libelektra.org
license:             BSD3
author:              e1528532
maintainer:          e1528532@libelektra.org
copyright:           libelektra.org
category:            plugin
build-type:          Custom
cabal-version:       >=1.24

@CABAL_CUSTOM_SETUP@

library
  hs-source-dirs:    "@CMAKE_CURRENT_SOURCE_DIR@"
  exposed-modules:   Elektra.RegexDispatcher
  other-modules:     Elektra.Dispatch
                   , Elektra.RangeDispatcher
                   , Elektra.Range
                   , Elektra.Parsers
  build-depends:     base >= 4.7 && < 5
                   , libelektra-haskell
                   , text
                   , megaparsec
  cpp-options:       -DENABLE_LOGGER_@ENABLE_LOGGER@
  default-language:  Haskell2010
  other-extensions:  ForeignFunctionInterface
  
source-repository head
  type:     git
  location: https://git.libelektra.org
